WWWWWWWWWW
W  S     W
W  RHHHV W
WR C      W
W  R   XWW
W  W  CC W
W  B  WW W
W        W
W     CC W
WWWWWWWWWW