WWWWWWWWWW
W  S     W
W  RHHHV W
W     C  W
W  R WWXWW
W  W     W
W   B    W
W   u    W
W   Y CT W
WWWWWWWWWW