WWWWWWWWWW
W  B     W
W  HHHHV W
W  R     W
W  R WWWWW
W  C W
W  S W   W
W    W   W
W        W
WWWWWWWWWW