WWWWWWWWWW
W        W
W        W
W    R   W
W        W
W  W S   W
W        W
W        W
W        W
WWWWWWWWWW