WWWWWWWWWW
W  S     W
W  RHHHV W
WR R     W
W  R WWXWW
W  C W
W  B W   W
W    W   W
W        W
WWWWWWWWWW